NO    ./textures/North.xpm

SO ./textures/South.xpm

WE    ./textures/West.xpm

EA ./textures/East.xpm

F    +255,   +255, 0



C   0,  42,   +55


111111111111
100000000001
101111111101
101      101
101111111101
100000S00001
111111111111
