NO ./textures/North.xpm
SO ./textures/South.xpm
EA ./textures/East.xpm
WE ./textures/West.xpm

C 255, 255, 0
F 0, 42, 55

11111111111
1E000000001
11111111111
