NO ./textures/North.xpm
SO ./textures/South.xpm
EA ./textures/East.xpm
WE ./textures/West.xpm

F 255, 255, 0
C 0, 42, 55

11111111111
11000000001
11111111111
