NO ./textures/North.xpm
SO ./textures/South.xpm
EA ./textures/East.xpm
WE ./textures/West.xpm

F 255, 255, 0
C 0, 42, 55

11111111111
1E00000000
11111111111
