NO ./assets/xpm/wall01.xpm
SO ./assets/xpm/wall021.xpm
EA ./assets/xpm/wall03.xpm
WE ./assets/xpm/wall041.xpm

F 188, 255, 0
C 89, 42, 55

        1111111111111111111111111
        1000000000110000000000001
        1011000001110000000000001
  111   10010000000000000000000011
111111111011000001110000000000001
100000000011000001110111111111111
11110111111111011100000010001
1111011111111101 101010010001
11000000110101011100000010001
10000000000000001100000010001
10000000000000001101010010001
11000001110101011111011110N0111
11110111 1110101 101111010001
1 111111 1111111 111111111111
