NO ./assets/xpm/wall01.xpm

SO ./assets/xpm/wall021.xpm


WE ./assets/xpm/wall03.xpm

F 255, 255, 0

C 0, 42, 55

EA ./assets/xpm/wall041.xpm

1111111111111
1111111111111
110N000000011
1111111111111
1111111111111
