NO ./assets/xpm/wall01.xpm
SO ./assets/xpm/wall03.xpm
WE ./assets/xpm/wall03.xpm
EA ./assets/xpm/wall03.xpm

F 255, 255, 0
C 0, 42, 55

11111111111
100000000N1
01111111111
