11111111111111111111111111111111
1000000000000000000a000000000001
10000000000000000000000000000001
10000000000000000000000000000001
1000000N000000000000000000000001
10000000000000000000000000000001
11111111111111111111111111111111