111111111111111111111111111
100000000000000000000100001
10000000000E0000000001000
111111111111111111111111111