111111111111111111111111
100000000110010001000001
100000000000000001000001
100000000000000001000001
100000000000000001000001
100000000000000001000001
1000000000E000000D000001
100000000000000001000001
100000000000000001000001
100000000000000001000001
100000000000000001000001
100000000000000001000001
111111111111111111111111